NO textures/file.xpm
EA textures/file1.xpm
WE textures/file2.xpm

F          50, 35, 58
SO textures/file3.xpm
C  77, 206, 193

11111111111111111111111111111111111
1000000000S000000000000000000000001
10001111000000001111000000011110001
10001001000001100001000011000010001
10001001111100100001011100111110001
10001000000000100000000100000000001
10001111111100111111110111111110001
10000000000100100000000100000010001
10111111110100101111000101111010001
10000000000100000001000000001000001
10000000011111111101111111111000001
10001111000000000100000000001111001
10001001001111000101111100001001001
10001001000001000001000100001001001
10001111111001001111000101111110001
10000000001000000000000100000000001
10000011111111001111111111100000001
10111111100001000000000100001111101
10000000100001111111000100000000001
10001111100000000001000011111000001
10001000111111001111001111001000001
10001000000001000000001000000000001
11111111111111111111111111111111111


