NO textures/file.xpm
EA textures/file1.xpm
WE textures/file2.xpm
SO textures/file3.xpm

F    220, 100,0
C   225, 30, 25

111111111111111111
110000000000000011
  10000000000001
   100000000001
    1000N00001
     10000001
      100001
       1001
        11