NO textures/file.xpm
EA textures/file1.xpm
WE textures/file2.xpm

F          50, 35, 58
SO textures/file3.xpm
C  77, 206, 193





111111111111111111111111111111
100010000000100000000000100001
101110101111101111111110111101
100000101000000000000010000101
101111101011111111111010111101
101000001010000000001010000101
101011111010111111101011111101
101010000000100000101000000101
101010111111101110101111110101
101010100000001010100000010101
101010101111111010111111010101
100010100000000010000001010001
111010111110111111111101011111
100010000010000000000101000001
101111111010111111110101111101
100000000010100000010100000101
111111111110101111010111110101
100000000000101000010000010101
101111111111101010111111110101
1000000000N0001010000000000101
111111111111111111111111111111


