NO textures/file.xpm
SO textures/file.xpm
WE textures/file.xpm
EA textures/file.xpm
F 50,50,50
C 135,206,235

        1111111111111111111111111
111111110000000000000001        
1000000000000000000000001
1000011001100110000011111
1000000000000000000000001
1011101110111000001111111
1000000000000000000000001
1001111001111001111000001
1000000000000000000000001
1011111011111011111000001
1000000000000000000000001
1001111001111001111000001
1000000000000000000000001
1011111011111011111111111
10000000000000000000000W1
1111111111111111111111111