NO textures/file.xpm
SO textures/file1.xpm
WE textures/file2.xpm
EA textures/file3.xpm

F 50,50,50
C 135,206,235


111111
10N001
111111