NO textures/file.xpm
SO textures/file1.xpm
WE textures/file2.xpm
EA textures/file3.xpm

F 50,50,50
C 135,206,235

11111111111111111111111111111111111111111111
1E00000000000000000000000000000000000000001
1111111111111111111111111110000000000000001
                          10000000000000001
                          11000000000000011
                          11100000000000111
                          11110000000001111
                          11111000000011111
                          11111100000111111
                          11111110001111111
                          11111111011111111
                          11111111011111111
                          11111111011111111
                          11100000000000111
                          11110000000001111
                          11111000000011111
                          11111100000111111
                          11111110001111111
                          11111111011111111
                          11111111011111111
                          11111111111111111