NO textures/file.xpm
SO textures/file.xpm
WE textures/file.xpm
EA textures/file.xpm
F 50,50,50
C 135,206,235

1111111111111111111111111
1001111001111001111000001
100000000000000000000000111111111111111111111111
101111101111101111100000000000000000000000000001
100E00000000000000000000111111111111111111111111
1001111001111001111000001
1111111111111111111111111